6 7
2 2 0
1 1 1 1 1 1 1
1 1 0 0 0 1 1
1 0 0 1 1 1 1
1 0 0 0 0 0 1
1 1 1 1 0 0 1
1 1 1 1 1 1 1

# answer : 9